            * * * * * * * 
* * * *     * * *     * * 
* * * * * * * * *     * * * * 
* S * *               * * T *
* * * *               * * * * 
                        * * * 