            * * * *     * * * 
* * * *     * * B *     * T *
* * A *     * * * *     * * *
* * * *     * * * *     * * * 
* S * * a a * * * * b b * * *
* * * *     * * * *