                      * * * * 
  * * * * a a * A * * * * S *
  * * * *               * * * 
  * * B *
  * * * * 
      * * * C * b b * * *
                    * * * * D
* * *               * * * * * 
* T * * * c c * * * * * *
* * * *
