* * * 
* S * * * *
* * * * * * * * * 
  * * * * * * * * * 
          * * T * *
            * * * 