                * * * *
                * * * *
* * *           *     * * * *
* S * * * * * * *       * T *
* * *         * * A     * * *
* * *         * * *     * * *
  * * a       *
    * * * * * *