          * * * * * *
          *     * * *
          *     * * * * *
S * * * * *           * * * *
        * * *         * * T *
        * * *           * * *
            *     * *
            * * * * *
            * * * * *
              * * *