  *   *   *
  * *   * * *
* * *   *   * * *
  S *   * * *
    * * T * * * *
  * * * * * * * *