  * * *   *   * *
* * * * * *   * *
* * * * * * * * *
* * *     S *   *
  * * * T   *
* *   *       * *