    * * * *
  * * * * *
* * * T * *
* * * *   *
  S * * *
  * * *