   * * * * *
* * * * * * *
    * *   S * *
  *   * * * *
* * * * T *
* * * * * *