* * *   * * * *
*   *     *   *
  * * * * * * * *
* T * *   S * * *
  * * * * * *   *